█████████████████████████████
█           █               █
█  $        █               D
█           ████████        █
█       █                   █
█       █   P        B      █
█   H   █                   █
█████████████████████████████