█████████████████DDD█████████
█                           █
█  $      $            $    █
█                    $      █
█           $               █
█████████████   █████████████
█                           █
█        B   X X   B        █
█                           █
█                           █
█             H        P    █
█████████████ddd█████████████