█████████████████   █████████
█                           █
█  $      $            $    █
█                    $      █
█           $               █
█████████████   █████████████
█                           █
█        B   X X   B        █
█                           █
█             H             █
█                      P    █
█████████████████████████████